{
  "cat": {
    "p": "1 1 0",
    "d": 2
  },
  "pillow": {
    "p": "4 6 1",
    "d": 4
  },
  "cubes": {
    "1 1 0": "--p---",
    "6 1 1": "---p--",
    "5 4 1": "p---p-",
    "5 3 5": "-----p",
    "0 3 4": "p-----",
    "1 0 4": "-p----",
    "2 2 1": "--p---",
    "7 2 2": "---p--",
    "6 5 2": "----p-",
    "6 4 6": "-----p",
    "1 4 5": "p---p-",
    "2 1 5": "pp-x--",
    "3 1 1": "-pp-pp",
    "4 1 1": "-p----",
    "1 0 5": "-p----",
    "4 6 1": "----p-"
  }
}
