{
  "cat": {
    "p": "1 3 2",
    "d": 0
  },
  "pillow": {
    "p": "0 0 0",
    "d": 1
  },
  "cubes": {
    "4 2 3": "-px--p",
    "0 3 3": "p-----",
    "0 4 3": "p-----",
    "4 3 1": "--p-x-",
    "4 2 0": "--p---",
    "6 3 2": "---px-",
    "1 3 2": "pxxxpx",
    "1 1 3": "-p----",
    "1 2 0": "--p---",
    "6 2 1": "--xp--",
    "5 2 5": "-----p",
    "5 3 4": "-----p",
    "4 2 5": "-----p",
    "4 5 4": "----p-",
    "4 4 2": "--p---",
    "1 3 5": "-----p",
    "3 2 3": "---p-x",
    "4 0 1": "pppxpp",
    "0 0 0": "ppxppx",
    "2 0 3": "-p----",
    "2 0 2": "pp-p--",
    "0 1 5": "-----p",
    "0 0 5": "-----p",
    "4 3 4": "x-xx-x",
    "2 3 1": "----p-",
    "2 0 0": "-pp---",
    "3 0 4": "---p--",
    "3 1 4": "---x--",
    "3 2 4": "x--x--",
    "2 1 4": "-----p",
    "0 0 2": "pp----"
  }
}
