{
  "cat": {
    "p": "1 0 3",
    "d": 1
  },
  "pillow": {
    "p": "5 0 3",
    "d": 1
  },
  "cubes": {
    "1 0 3": "-p----",
    "5 0 3": "-p----",
    "1 0 5": "p----p",
    "1 1 5": "-----p",
    "1 0 1": "-pp---",
    "3 0 2": "-p-p--",
    "4 0 2": "pp----",
    "4 0 1": "-p----",
    "3 4 2": "--p-p-",
    "3 5 2": "p-----",
    "2 0 4": "-p----",
    "2 0 3": "-p----",
    "3 0 3": "-p----",
    "2 0 7": "p----p",
    "2 5 3": "--p-p-",
    "2 6 6": "----p-",
    "2 3 3": "-pp-xp",
    "5 2 4": "-pp--x",
    "5 3 3": "--p---",
    "5 0 7": "---p-x",
    "5 1 7": "-----p",
    "5 2 7": "-----x",
    "5 3 7": "-----p",
    "5 4 7": "-----p",
    "5 1 1": "-pp---",
    "5 4 2": "-xp--p",
    "5 3 2": "--x-xp",
    "7 3 3": "p-pp-p",
    "6 3 7": "-----p",
    "7 3 7": "xxxxxx",
    "8 3 7": "-----p",
    "9 3 7": "-----p",
    "0 1 3": "p-x---",
    "8 0 5": "xpxpx-",
    "8 0 4": "xp-px-",
    "8 0 3": "xp-px-",
    "8 0 2": "xp-pxx",
    "8 0 1": "---p--",
    "8 1 1": "---p--",
    "8 2 1": "---p--",
    "5 3 0": "--pp--",
    "0 3 4": "p----p",
    "0 4 4": "x-----",
    "0 4 3": "p---x-",
    "0 3 0": "pxp---",
    "2 0 0": "--p---",
    "3 0 0": "x-p---",
    "9 5 4": "--xp--",
    "9 4 4": "--x---",
    "9 3 4": "--xp--",
    "3 5 7": "----p-",
    "2 4 7": "p-----",
    "9 3 2": "---p--",
    "9 4 2": "---p--",
    "9 5 2": "---p--",
    "9 4 7": "---p-p",
    "8 4 1": "--p---",
    "3 2 1": "p-----"
  }
}
